S..######.#####
##..#####...###
###...###..#.##
......###.##.##
##.##........##
##.#####...#.##
...#..##..##..#
##.......###..#
.....####..####
####.##...#####
##......##..###
##..##.###..###
#...##.....##.#
####....####..#
###..##.......F
$$$////////////
